GGGGGGGMGMGMGMGGGGGAAAAGGGGGGGGMGMMMMMGGGG
MGMMMMGGGGGMGMGMMMMAAAAGGMMMMGGMGGGGGMGMMM
GGGGGGGMMMMMGMGGGGAAAAAAGGGGMGGMGMMMGMGMMM
GMMMMGGMGGGGGGGGAAAAAAAAAAGGMGGMGGGMGGGGGG
GMGGMGGMGMGMMMGAAAAAAAAAAAAGMMGMMMGMMMMGMM
GMGGMGGGGMGGMGGAAAAAAAAAAAAGGGGGGMGGGGMGGG
GMMGMGGMGMGMAAAAAAAAAAAAAAAAAGGMGMMMMGMMMM
GGGGMMMMGMGMAAAAAAAGGGGAAAAAAAGGGGGGGGGGGG
GGGGMGGGGMAAAAAAAAMMMMGGGAAAAAAAGMMMGMMMMM
GMMMMMMGGGAAAAAAGGMGGGGMMGAAAAAAGMGMGMGGGG
GGGMGGGGAAAAAAAAGGMMMMGGGGGGAAAAGMGMGMMGMM
GGMMAAAAAAAAAAAAGGGGGMGMMMGGGAAAGGGGGGGGGG
MMAAAAAAAAAAAAAAAGMMGMGMGGGGGAAAAAGMMMMGMG
AAAAAAGGAAAAAAAAAAGGGMGGGAAAAAAAAAGGGGMGMG
AAAAAAGGAAAAAAAAAAAAGGGGAAAAAAAAAAAAAGMGMG
AAAAAGGMMMGAAAAAAAAAAAAAAAAAAAAGAAAAAGMMMM
AAAMGGGMGMGAAAAAAAAAAAAAAAAAAAMGMAAAAGGGGG
AAGMGMMMGMGAAAAAAAAGAAAAAAAAAAMGMMAAAAGMMG
GGMMGGGMGMMAAAAAAAGGGAAAAAAAAAMGMAAAAAAGMG
MMMGGMMMGGGAAAAAAGGGGGAAAAAAAAAAAAAAAAAGMM
GGGGGMGGAAAAAAAAAAGGGAAAAAAAAGGGGGAAAAAAGG
MMGMMMGAAAAAAAAAAAAGAAAAAAAAAGMMMMAAAAAAAA
GGGGMGGAAAAMMMAAAAAAAAAAAAAMMMMGGMAAAAAAAA
GMMMMGGAAAGGGMAAAAAAAAAAAAAMGGGGGMAAAGGAAA
GMGGGGMAAAAMMMAAAAAAAAAAAAGMGMMMGMMMGGGGAA
GMGGMMMMGAAAAAAAAAAAAAAAAAMMGMGMGGMGMMMGAA
GGGGMGGMGAAAAAAAAMMMAAAAAAGGGMGGGMMGMGMGAA
AGMGMGGGGGGGGAAAGGGGGGAAAAMMGMMMGMGGGGMGAA
AGMGMMMMGGMMGAAAGGMMGGAAAAGMGGGGGGGMMMMGAA
AAAGGGGMGGMGGAAAMGGMMGAAAAGMMMMMGMMGGGAAAA
AAAGMMGGGGGGGAAAAMGGMGAAAAAAMGGGGMGAAAAAAA
AAAAAMGAAAAAAAAAAAAGGGAAAAAAMMMMMMAAAAMMMM
GAAAAMGAAAAAAAAAAAAAGGAAAAAAGGGGGGAAAMMGGG
GGMAAAAAAAAAAAAAAAAAAAAAAAAAAAAAAAAAAMGGMG
GGMAAAAAAAAAAAAAAAAAAAAAAAAAAAAAAAAAAGGGMG
GAAAAGGAAAAAAAAAGGGGGGGGGAAAAAAAAAAAAMMGGG
AAAAAGMAAAAAAAAGGMMMGMMMGGGAAAAAGGGAAAMMMM
AAAAAGGGAAAAAAMGGGGGGMGMGMMAAAAGMGMGAAAAAA
AAAGGGGGAAAAAMMGGGGGGMGMGGGMGAAGMGMGAAAAAA
AAAGMMGMMMGAGMGGMGMMMMGMMMGMGAAGMGMGGGGAAA
AGGGGGGGGMGGGGGGGGMGGGGGGMGMGGGMMGMMGGMGAA
AGMMGGMMGGGGGMGMMGGGMMGMGGGGGMGGGGGGMGGGAA
